44444444444444444444444444444444444444444444
40000000000000000000000000000000000000000004
01111000000000000000000000000000002220000004
40001000001111111111111111111110002220000004
40001000001000000000000000000010000000000004
40001000001000000000000000000010000000000004
40001000001000333333333333300010000000000004
40001000001000333333333333300010000333300004
40001111111000333333333333300010000333300004
40000000000000333333333333300010000333300004
40000000000000333333333333300010000000000004
40000000000000000000000000000010000000000004
40000000000001111111111111111110000000000004
40000000000001000000000000000000000000000004
40000222200001000000000000000000000000000004
40000222200001000000002222222222000000000004
40000222200001000000002222222222000000000004
40000222200001000000002222222222000000000004
40000222200001000000002222222222000000000004
40000222200001000000000000000000000000000004
40000000000001000000000000000000000000000004
40004440000001000000000000000000000000000004
40004440000001111111111111111111111111110004
40000000000000000000000000000000000000000004
44444444444444444444444444444444444444444444
