44444444444444444444444444444444444444444444
40000000000000000000000000000000000000000004
08888000000000000000000000000000002220000004
40008000008888888888888888888880002220000004
40008000008000000000000000000080000000000004
40008000008000000000000000000080000000000004
40008000008000333333333333300080000000000004
40008000008000333333333333300080000333300004
40008888888000333333333333300080000333300004
40000000000000333333333333300080000333300004
40000000000000333333333333300080000000000004
40000000000000000000000000000080000000000004
40000000000008888888888888888880000000000004
40000000000008000000000000000000000000000004
40000222200008000000000000000000000000000004
40000222200008000000002222222222000000000004
40000222200008000000002222222222000000000004
40000222200008000000002222222222000000000004
40000222200008000000002222222222000000000004
40000222200008000000000000000000000000000004
40000000000008000000000000000000000000000004
40004440000008000000000000000000000000000004
40004440000008888888888888888888888888880004
40000000000000000000000000000000000000000004
44444444444444444444444444444444444444444444
