44444444444444444444444444444444444444444444
40000000000000000000000000000000000000000004
40111111111110000000000000000000000000000004
40000000000110000000000000000000000000000004
40000000000111111111111111000000000000000004
40000000000000000000000111000000000000000004
40000000000000000000000111000000000000000004
40000000000000000000000111000000000000000004
40000000000000000000000111111110000000000004
40000000000000000000000000000110000000000004
40000000000000000000000000000110000000000004
40000000000000000000000000000110000000000004
40000000000000000000000000000111111111100004
40000000000000000000000000000000000000100004
40000000000000000000000000000000000000100004
40000000000000000000000000000000000000100004
40000000000000000000000000000000000000100004
40000000000000000000000000000000000000111104
40000000000000000000000000000000000000000004
40004444440000000000000000000000000000000004
40000000000000000000000000000000000000000004
40000000000000000000000000000000000000000004
40000000000000000000000000000000000000000004
44444444444444444444444444444444444444444444
