44444444444444444444444444444444444444444444
47777777777777777777777777777777777777777774
71111177777777777777777777777777777777777774
47777177771111111111111111177777777777777774
47777177771777777777777777177711111177777774
47777177771777777777777777177717777177777774
47777177771777777777777777177717777177777774
47777177771111111111111777177717777177777774
47777177777777777777771777177717777177777774
47777177777777733337771777177717777177777774
47777111111777733337771777177717777177777774
47777777771777733337771777111117777177777774
47777777771777777777771777777777777177777774
47777777771777777777771777771111111177777774
47777777771777777777771777771777777777777774
47777777771111111111111777771777777777777774
47777777777777777777777777771777777777777774
47777777711111111111111111111777777777777774
47777777717777777777777777777777777777777774
47777777711111111111111111111111111111177774
47777777777777777777777777777777777777177774
47777777777777777777777777777777777777177774
47777111111111111111111111111111111111177774
47777777777777777777777777777777777777777774
44444444444444444444444444444444444444444444
