44444444444444444444444477777777777777777777
40000000000000000000000077777777777777777777
08888888888800000000000077777777777777777777
40000000000800000008888811111111111111177777
40000000000800000008000077777777777777177777
40000000000800000008000077777777777777177777
40000000000800000008000077777777777777177777
40000088888800000008000077777777777777177777
40000080000000000008000077777777777777177777
40000080000000000008000077777777777777177777
40000080000000000008000077777777777777177777
40000080000000000008888811777777777777177777
40000080000000000000000071777711111111177777
40000080000000000000000071777717777777777777
40000080000000000000000071777717777777777777
40000080000000000000000071777717777777777777
40000080000000000000000071777717777777777777
40000080000000000008888811777717777777777777
40000080000000000000000077777711111177777777
40000080000000000000000077777777777177777777
40000080000000000000000077777777777177777777
40000088888888888888888811111111111177777777
70000000000000000000000077777777777777777777
70000000000000000000000077777777777777777777
44444444444444444444444477777777777777777777
